XXXXXXXXXXXXXXXXXXXXXXXXXXXXXXXXXXXXXXXXXXXXXXXXXXX
XSX...Xbbbbbbbbbb...XbbbbbbbbbbbbbbbbbXbbbbbbbb...X
X.X.X.XXXXXXXbXXX.X.XXXbXXXXXXXXXXXXXbXbXXXXXXX.X.X
X...X.X.....XbX...X...XbbbbbXbbbbbbbXbbbbbbbX...X.X
XXXXX.X.XXX.XXX.XXXXX.XXXXXbXXXXXbXXXXXXXXXXX.XXX.X
XbbbX...XbX...X...XbX.XbbbbbbbbbbbX.....X.....XbX.X
XbXXXXXXXbXXX.XXX.XbX.XXXXXXXbXXXXX.XXX.X.XXXXXbX.X
XbbbbbbbbbXbX...X.XbX.......XbX.....XbX...X...X...X
XbXXXXXXXbXbXXX.X.XbXXXXXXX.XXX.XXXXXbXXXXX.X.X.XXX
XbXbbbXbXbbbbbX...XbX.......X...XbbbbbbbbbX.X...XbX
XbXbXbXbXbXXXbXXXXXbX.XXXXXXX.XXXXXbXXXXXbX.XXXXXbX
XbbbXbbbXbbbXbX.......XbXbbbb.X...XbbbXbbbX.X...XbX
XXXXXXXXXXXbXbX.XXXXXXXbXbXXX.X.X.XXXbXbXbX.X.X.XbX
XbbbbbbbbbXbXbX...XbXbbbXbXbX.X.X...XbXbXbX.X.X.XbX
XbXXXXXXXbXbXbXXX.XbXbXbXbXbX.X.XXX.XXXbXbX.X.X.XbX
XbXbbbbbXbXbXbX...XbbbXbXbbbX.X.X...XbbbXbX...X...X
XbXXXXXbXbXbXbX.XXXbXXXbXXXbX.X.X.XXXbXXXXXXXXXXX.X
XbbbbbXbbbbbXbX.XbXbXbXbXbbbX...X.XbbbXbbbbbbbbbX.X
XXXXXbXbXXXXXXX.XbXbXbXbXbXXXXXXX.XXXbXbXbXXXXXXX.X
XbbbbbXbXbbbbbX.XbbbXbXbXbXbbbbbX...XbbbXbbbbbX...X
XbXXXXXXXbXXXbX.XXXbXbXbXbXbXXXXXXX.XXXbXXXXXbX.XXX
XbbbbbbbXbXbXbX...XbbbXbXbXbbbbbbbX...XbXbbbbbX.XbX
XbXXXXXbXbXbXbXXX.XXXbXbXbXbXXXbXXXXX.XbXbXXXXX.XbX
XbbbbbXbXbbbXbbbX.XbXbXbbbXbXbXbX...X.XbXbbbbbX...X
XXXXXXXbXbXXXXXbX.XbXbXXXXXbXbXbX.X.X.XbXXXXXbXXX.X
XbbbXbbbXbXbbbbbX.XbXbbbbbXbbbXbX.X.X.XbbbbbXbbbX.X
XbXbXbXXXbXbXXXXX.XbXXXXXbXXXXXbX.X.X.XXXXXXXbXXX.X
XbXbbbXbbbXbbbX...XbbbbbXbXbbbbbX.X...XbbbbbXbbbX.X
XbXXXbXbXXXXXbX.XXXbXXXXXbXbXXXXX.XXXXXbXXXbXXXbX.X
XbbbXbXbbbbbXbX...XbbbbbbbbbX...X.XbbbbbXbXbXbbbX.X
XbXbXXXXXXXbXbXXX.XbXXXXXXXXX.X.X.XbXXXXXbXbXbXXX.X
XbXbXbbbbbbbXbbbX.XbbbbbbbX...X.X.XbXbXbbbbbXbX...X
XbXbXbXXXXXXXXXbX.XXXXXXXbX.XXX.X.XbXbXbXXXXXbX.XXX
XbXbbbXbbbbbXbbbX.X...XbbbX.XbX.X.XbXbbbbbbbbbX.XbX
XbXXXXXXXbXbXbXXX.X.X.XXXXX.XbX.X.XbXXXXXXXXXbX.XbX
XbbbXbbbbbXbXbX...X.X.X...X.XbX...XbX...X...XbX...X
XXXbXbXbXbXXXbX.XXX.X.X.X.X.XbXXXXXbX.X.X.X.XXXXX.X
XbXbXbXbXbXbbbX.Xbb.X...X...XbbbbbbbX.X...X.......X
XbXbXXXbXbXbXXX.XXX.XXXXXXXXXbXXXXXXX.XXXXXXXXXXXXX
XbXbbbbbXbXbbbX.....XbbbbbbbbbX.......Xbb...XbbbbbX
XbXXXXXXXbXXXbXXXXXXXbXXXXXXXbX.XXXXXXXbX.X.XXXbXbX
XbbbXbXbbbXbXbbbXbbbXbbbbbXbbbX.XbbbbbXbX.X...XbXbX
XbXbXbXbXXXbXbXXXbXbXbXXXbXXXbX.XXXbXbXbX.XXX.XbXXX
XbXbbbXbbbbbXbbbbbXbXbbbXbbbXbX...XbXbXbX.X...XbbbX
XbXXXXXXXXXbXXXXXXXbXXXbXXXbXbXXX.XbXXXbX.X.XXXbXbX
XbXbbbbbbbXbbbXbbbXbbbXbXbbbXbbbX.XbXbbbX.X.XbbbXbX
XbXbXXXbXXXXXbXbXbXbXXXbXbXbXXXXX.XbXbXXX.X.XXXXXbX
XbXbXbXbXbbbXbbbXbXbbbXbXbXbX.....XbbbX...X...X...X
XbXbXbXbXbXbXXXXXbXXXbXbXbXXX.XXXXXXXXX.XXXXX.X.X.X
XbbbbbXbbbXbbbbbbbbbXbbbXbbbb...........Xbbbb...XFX
XXXXXXXXXXXXXXXXXXXXXXXXXXXXXXXXXXXXXXXXXXXXXXXXXXX